Ismétlés
Középkor/újkor határán

Reneszánsz:
    Dante Alighieri: Isteni színjáték
    Francois Villon
    Francesco Petrarca: Daloskönyv
    Giovanni Boccaccio: Dekameron
    Shakespeare -- drámák

Magyar reneszánsz:
    Janus Pannonius -- epigramma, elégia
    Balassi Bálint -- vitézi/szerelmi/vallásos költészet

Barokk/ellenreformáció:
    Pázmány Péter: prédikációk
    Zrínyi Miklós: Szigeti veszedelem
    Mikes Kelemen: Törökországi levelek <- rokokó

Felvilágosodás:
    Klasszicizmus:
        Daniel Defoe: Robinson
        Swift: Gulliver utazásai
        Voltaire: Candide
        Goethe: Faust
        Moliére: Tartuffe

Magyar Felvilágosodás:
    Bessenyei György
    Kármán József: Fanni hagyományai
    Kazinczy Ferenc -- epigrammák
        nyelvújítás
    Csokonai Vitéz Mihály: Rokokó-dalok
    Berzsenyi Dániel -> "magyar Horatius"; ódák/elégiák
    Kölcsey Ferenc